###############################################
#                 a         #                 #
#  1    ###############     #                 #
#       #             #     #                 #
#       #                                     #
#       #                                     #
#       #             #     #                 #
#       #             #     #                 #
#       #             #     #                 #
#       ###############     #                 #
#                           #                 #
#                           #                 #
#                           #                 #
#                           #                 #
###############################################
